000000000000000000000000000
000000000000000000000000000
000000000000000000000000000
666500000000000000000000000
000500000000000000000000000
000520000000000000000000000
000666666650000000000000000
000000000052000000000000066
000000000066665200000000240
000000000000006666666666640
000000000000000000000000000
000000000000000000000000000
*